NO ./north.xpm
S ./south.xpm
W ./west.xpm
EA ./east.xpm

F 50,50,50
C 0,153,102
11111111111111111
11N1110000111111111         111111
1000000000000111111     110011
1000000000000111              110011
111111111111111111111   11111111111
