NO ./north.xpm
S ./south.xpm
W ./west.xpm
EA ./east.xpm

F 50,50,50
C 0,153,102


111111111111111111111111
111100000000S00000000001   
  1000000000000000001111
  11111111111111111111
